2 2 2 2 2 2 2 2 2 2 2 2 2 2 2 2 2 2 2 2 2 2 2 2 2 2 2 2 2 2 2 2 2 2 2 2 2 2 2 2 2 2 2 2 2 2 2 2 2 2
2 2 2 2 2 2 2 2 2 2 2 2 2 2 2 2 2 2 2 2 2 2 2 2 2 2 2 2 2 2 2 2 2 2 2 2 2 2 2 2 2 2 2 2 2 2 2 2 2 2
2 2 2 2 2 2 2 2 2 2 2 2 2 2 2 2 2 2 2 2 2 2 2 2 2 2 2 2 2 2 2 2 2 2 2 2 2 2 2 2 2 2 2 2 2 2 2 2 2 2
2 2 2 2 2 2 2 2 2 2 2 2 2 2 2 2 2 2 2 2 2 2 2 2 2 2 2 2 2 2 2 2 2 2 2 2 2 2 2 2 2 2 2 2 2 2 2 2 2 2
2 2 2 2 2 2 2 2 2 2 2 2 2 2 2 2 2 2 2 2 2 2 2 2 2 2 2 2 2 2 2 2 2 2 2 2 2 2 2 2 2 2 2 2 2 2 2 2 2 2
2 2 2 2 2 2 2 2 2 2 2 2 2 2 2 2 2 2 2 2 2 2 2 2 2 2 2 2 2 2 2 2 2 2 2 2 2 2 2 2 2 2 2 2 2 2 2 2 2 2
2 2 2 2 2 2 2 2 2 2 2 2 2 2 2 2 2 2 2 2 2 2 2 2 2 2 2 2 2 2 2 2 2 2 2 2 2 2 2 2 2 2 2 2 2 2 2 2 2 2
2 2 2 2 2 2 2 2 16 7 7 7 7 7 7 7 7 7 7 7 7 7 7 7 7 7 7 7 7 7 7 17 2 2 2 16 7 7 7 7 7 17 2 2 2 2 2 2 2 2
2 2 2 2 2 2 2 2 8 0 0 0 3 3 3 3 3 3 3 3 3 3 0 0 0 0 0 0 0 0 3 11 7 7 7 13 3 3 0 0 0 9 2 2 2 2 2 2 2 2
2 2 2 2 2 2 2 2 8 0 0 0 3 3 3 3 3 3 3 3 3 0 0 10 6 6 12 0 0 3 3 3 3 3 3 3 3 0 0 0 0 9 2 2 2 2 2 2 2 2
2 2 2 2 2 2 2 2 8 0 0 0 3 3 3 3 3 3 3 3 3 0 0 9 2 2 8 0 0 3 3 3 3 3 3 3 3 0 0 0 0 9 2 2 2 2 2 2 2 2
2 2 2 2 2 2 2 2 8 0 0 0 3 3 3 3 3 3 3 3 3 0 0 11 7 7 13 0 0 3 3 3 3 3 3 3 3 0 0 0 0 9 2 2 2 2 2 2 2 2
2 2 2 2 2 2 2 2 8 0 0 0 3 3 3 3 3 3 3 3 3 0 0 0 0 0 0 0 0 3 3 3 3 3 3 3 3 3 0 0 0 9 2 2 2 2 2 2 2 2
2 2 2 2 2 2 2 2 15 12 0 0 0 0 3 3 3 3 3 3 3 3 0 0 0 0 0 0 3 3 3 3 3 3 3 3 3 0 0 0 0 9 2 2 2 2 2 2 2 2
2 2 2 2 2 2 2 2 16 13 0 0 0 0 3 3 3 3 3 3 3 3 0 0 0 0 0 3 3 3 3 3 3 3 3 3 3 0 0 0 0 9 2 2 2 2 2 2 2 2
2 2 2 2 2 2 2 2 8 3 3 3 3 0 0 3 3 3 3 3 3 3 3 0 0 0 0 3 3 3 3 3 3 3 3 3 3 3 0 0 0 9 2 2 2 2 2 2 2 2
2 2 2 2 2 2 2 2 8 3 3 3 3 3 0 3 3 3 3 3 3 3 3 0 0 0 0 3 3 3 3 3 3 3 3 3 3 3 0 0 0 9 2 2 2 2 2 2 2 2
2 2 2 2 2 2 2 2 8 3 3 3 3 0 0 3 3 3 3 3 3 3 3 0 0 0 0 3 3 3 3 3 3 3 3 3 3 3 0 0 3 9 2 2 2 2 2 2 2 2
2 2 2 2 2 2 2 2 8 3 0 0 0 0 3 3 3 3 3 3 3 3 3 0 0 0 0 3 3 3 3 3 3 3 3 3 3 3 0 0 3 9 2 2 2 2 2 2 2 2
2 2 2 2 2 2 2 2 8 3 0 3 3 3 3 3 3 3 3 3 3 3 0 0 0 0 0 3 3 3 3 3 3 3 3 3 3 0 0 0 0 9 2 2 2 2 2 2 2 2
2 2 2 2 2 2 2 2 8 3 0 3 3 3 3 3 3 3 3 3 3 3 0 0 0 0 0 0 3 3 3 3 3 3 3 3 0 0 0 0 0 9 2 2 2 2 2 2 2 2
2 2 2 2 2 2 2 2 8 3 0 3 3 3 3 3 3 3 3 3 0 0 0 0 0 0 0 0 3 3 3 3 3 3 3 3 0 0 0 0 0 9 2 2 2 2 2 2 2 2
2 2 2 2 2 2 2 2 8 3 0 0 3 3 3 3 3 3 3 3 0 0 0 0 0 0 0 0 0 0 0 0 0 0 0 0 0 0 0 0 0 9 2 2 2 2 2 2 2 2
2 2 2 2 2 2 2 2 8 3 3 0 0 0 0 0 0 3 3 0 0 0 0 0 0 0 0 0 0 0 0 0 0 0 0 0 0 0 0 0 0 9 2 2 2 2 2 2 2 2
2 2 2 2 2 2 2 2 8 3 3 3 3 3 0 0 0 0 0 0 0 0 0 0 0 0 0 0 0 0 0 0 0 0 0 0 0 0 0 0 0 9 2 2 2 2 2 2 2 2
2 2 2 2 2 2 2 2 8 3 3 3 3 3 0 0 0 0 0 0 0 0 0 0 0 0 0 0 0 0 0 0 0 3 3 0 0 0 0 0 0 9 2 2 2 2 2 2 2 2
2 2 2 2 2 2 2 2 8 3 3 3 3 3 3 0 0 0 0 0 0 0 0 0 0 0 0 0 0 0 0 0 3 3 3 3 0 0 0 0 0 9 2 2 2 2 2 2 2 2
2 2 2 2 2 2 2 2 8 3 3 3 3 3 3 0 0 0 0 0 0 3 3 3 0 0 0 0 0 0 3 3 3 3 3 3 3 0 0 0 0 9 2 2 2 2 2 2 2 2
2 2 2 2 2 2 2 2 15 6 6 6 6 12 3 0 0 0 0 3 3 3 3 3 0 0 0 0 0 3 3 3 3 3 3 3 0 0 0 0 0 9 2 2 2 2 2 2 2 2
2 2 2 2 2 2 2 2 16 7 7 7 7 13 3 0 0 0 3 3 3 3 3 3 0 0 0 0 0 3 3 3 3 3 3 3 0 0 0 0 0 9 2 2 2 2 2 2 2 2
2 2 2 2 2 2 2 2 8 3 3 3 3 3 3 0 0 0 0 3 3 3 3 3 0 0 0 0 0 0 3 3 3 3 3 3 0 0 0 0 0 9 2 2 2 2 2 2 2 2
2 2 2 2 2 2 2 2 8 3 3 3 3 3 0 0 0 0 0 3 3 3 3 0 0 0 0 0 0 0 3 3 3 3 3 3 3 0 0 0 0 9 2 2 2 2 2 2 2 2
2 2 2 2 2 2 2 2 8 3 3 3 3 0 0 0 0 0 0 3 3 3 3 0 0 0 0 0 0 0 3 3 3 3 3 3 3 0 0 0 0 9 2 2 2 2 2 2 2 2
2 2 2 2 2 2 2 2 8 3 3 3 0 0 0 0 0 0 0 3 3 3 3 0 0 0 0 0 0 0 3 3 3 3 3 3 3 0 0 0 0 9 2 2 2 2 2 2 2 2
2 2 2 2 2 2 2 2 8 3 3 0 0 0 0 0 0 0 0 3 3 3 3 0 0 0 0 0 0 0 3 3 3 3 3 3 0 0 0 0 0 9 2 2 2 2 2 2 2 2
2 2 2 2 2 2 2 2 8 0 0 0 0 0 0 0 0 3 3 3 3 3 3 3 0 0 0 0 3 3 3 3 3 3 3 3 0 0 0 0 0 9 2 2 2 2 2 2 2 2
2 2 2 2 2 2 2 2 8 0 0 0 0 0 0 0 3 3 3 3 3 3 3 3 0 0 0 0 3 3 3 3 3 3 3 3 0 0 0 0 0 9 2 2 2 2 2 2 2 2
2 2 2 2 2 2 2 2 8 0 0 0 0 0 3 3 3 3 3 3 3 3 0 0 0 0 0 0 0 0 3 3 3 3 3 3 3 0 0 0 0 9 2 2 2 2 2 2 2 2
2 2 2 2 2 2 2 2 8 0 0 0 0 0 3 10 6 6 12 3 3 0 0 0 0 0 0 0 0 0 3 3 3 3 3 3 3 0 0 0 0 9 2 2 2 2 2 2 2 2
2 2 2 2 2 2 2 2 8 0 0 0 0 3 3 9 2 2 8 3 3 3 0 0 0 0 0 0 0 0 0 10 6 12 3 3 3 0 0 0 0 9 2 2 2 2 2 2 2 2
2 2 2 2 2 2 2 2 8 0 0 0 3 3 3 9 2 2 8 3 3 3 3 0 0 0 0 0 0 0 0 9 2 8 3 3 3 3 0 0 0 9 2 2 2 2 2 2 2 2
2 2 2 2 2 2 2 2 15 6 6 6 6 6 6 14 2 2 15 6 6 6 6 6 6 6 6 6 6 6 6 14 2 15 6 6 6 6 6 6 6 14 2 2 2 2 2 2 2 2
2 2 2 2 2 2 2 2 2 2 2 2 2 2 2 2 2 2 2 2 2 2 2 2 2 2 2 2 2 2 2 2 2 2 2 2 2 2 2 2 2 2 2 2 2 2 2 2 2 2
2 2 2 2 2 2 2 2 2 2 2 2 2 2 2 2 2 2 2 2 2 2 2 2 2 2 2 2 2 2 2 2 2 2 2 2 2 2 2 2 2 2 2 2 2 2 2 2 2 2
2 2 2 2 2 2 2 2 2 2 2 2 2 2 2 2 2 2 2 2 2 2 2 2 2 2 2 2 2 2 2 2 2 2 2 2 2 2 2 2 2 2 2 2 2 2 2 2 2 2
2 2 2 2 2 2 2 2 2 2 2 2 2 2 2 2 2 2 2 2 2 2 2 2 2 2 2 2 2 2 2 2 2 2 2 2 2 2 2 2 2 2 2 2 2 2 2 2 2 2
2 2 2 2 2 2 2 2 2 2 2 2 2 2 2 2 2 2 2 2 2 2 2 2 2 2 2 2 2 2 2 2 2 2 2 2 2 2 2 2 2 2 2 2 2 2 2 2 2 2
2 2 2 2 2 2 2 2 2 2 2 2 2 2 2 2 2 2 2 2 2 2 2 2 2 2 2 2 2 2 2 2 2 2 2 2 2 2 2 2 2 2 2 2 2 2 2 2 2 2
2 2 2 2 2 2 2 2 2 2 2 2 2 2 2 2 2 2 2 2 2 2 2 2 2 2 2 2 2 2 2 2 2 2 2 2 2 2 2 2 2 2 2 2 2 2 2 2 2 2
2 2 2 2 2 2 2 2 2 2 2 2 2 2 2 2 2 2 2 2 2 2 2 2 2 2 2 2 2 2 2 2 2 2 2 2 2 2 2 2 2 2 2 2 2 2 2 2 2 2