2 2 2 2 2 2 2 2 2 2 2 2 2 2 2 2 2 2 2 2 2 2 2 2 2 2 2 2 2 2 2 2 2 2 2 2 2 2 2 2 2 2 2 2 2 2 2 2 2 2
2 2 2 2 2 2 2 2 2 2 2 2 2 2 2 2 2 2 2 2 2 2 2 2 2 2 2 2 2 2 2 2 2 2 2 2 2 2 2 2 2 2 2 2 2 2 2 2 2 2
2 2 2 2 2 2 2 2 2 2 2 2 2 2 2 2 2 2 2 2 2 2 2 2 2 2 2 2 2 2 2 2 2 2 2 2 2 2 2 2 2 2 2 2 2 2 2 2 2 2
2 2 2 2 2 2 2 2 2 2 2 2 2 2 2 2 2 2 2 2 2 2 2 2 2 2 2 2 2 2 2 2 2 2 2 2 2 2 2 2 2 2 2 2 2 2 2 2 2 2
2 2 2 2 2 2 2 2 2 2 2 2 2 2 2 2 2 2 2 2 2 2 2 2 2 2 2 2 2 2 2 2 2 2 2 2 2 2 2 2 2 2 2 2 2 2 2 2 2 2
2 2 2 2 2 2 2 2 2 2 2 2 2 2 2 2 2 2 2 2 2 2 2 2 2 2 2 2 2 2 2 2 2 2 2 2 2 2 2 2 2 2 2 2 2 2 2 2 2 2
2 2 2 2 2 2 2 2 2 2 2 2 2 2 2 2 2 2 2 2 2 2 2 2 2 2 2 2 2 2 2 2 2 2 2 2 2 2 2 2 2 2 2 2 2 2 2 2 2 2
2 2 2 2 2 2 2 2 16 7 7 7 7 7 7 7 7 7 7 7 7 7 7 7 7 7 7 7 7 7 7 17 2 2 2 16 7 7 7 7 7 17 2 2 2 2 2 2 2 2
2 2 2 2 2 2 2 2 8 18 18 18 18 18 18 18 18 18 18 18 18 18 18 18 18 18 18 18 18 18 18 11 7 7 7 13 18 18 18 18 18 9 2 2 2 2 2 2 2 2
2 2 2 2 2 2 2 2 8 18 18 18 18 18 18 18 18 18 18 18 18 18 18 18 18 18 18 18 18 18 18 18 18 18 18 18 18 18 18 18 18 9 2 2 2 2 2 2 2 2
2 2 2 2 2 2 2 2 8 18 18 18 18 18 18 18 18 18 18 18 18 2 2 2 18 18 18 18 18 18 18 18 18 18 18 18 18 18 18 18 18 9 2 2 2 2 2 2 2 2
2 2 2 2 2 2 2 2 8 18 18 18 18 18 18 18 18 18 18 18 18 2 2 2 18 18 18 18 18 18 18 18 18 18 18 18 18 18 18 18 18 9 2 2 2 2 2 2 2 2
2 2 2 2 2 2 2 2 8 18 18 18 18 18 18 18 18 18 18 18 18 18 18 18 18 18 18 18 18 18 18 18 18 18 18 18 18 18 18 18 18 9 2 2 2 2 2 2 2 2
2 2 2 2 2 2 2 2 15 12 18 18 18 18 18 18 18 18 18 18 18 18 18 18 18 18 18 18 18 18 18 18 18 18 18 18 18 18 18 18 18 9 2 2 2 2 2 2 2 2
2 2 2 2 2 2 2 2 16 13 18 18 18 18 18 18 18 18 18 18 18 18 18 18 18 18 18 18 18 18 18 18 18 18 18 18 18 18 18 18 18 9 2 2 2 2 2 2 2 2
2 2 2 2 2 2 2 2 8 18 18 18 18 18 18 18 18 18 18 18 18 18 18 18 18 18 18 18 18 18 18 18 18 18 18 18 18 18 18 18 18 9 2 2 2 2 2 2 2 2
2 2 2 2 2 2 2 2 8 18 18 18 18 18 18 18 18 18 18 18 18 18 18 18 18 18 18 18 18 18 18 18 18 18 18 18 18 18 18 18 18 9 2 2 2 2 2 2 2 2
2 2 2 2 2 2 2 2 8 18 18 18 18 18 18 18 18 18 18 18 18 18 18 18 18 18 18 18 18 18 18 18 18 18 18 18 18 18 18 18 18 9 2 2 2 2 2 2 2 2
2 2 2 2 2 2 2 2 8 18 18 18 18 18 18 18 18 18 18 18 18 18 3 3 3 3 3 18 18 18 18 18 18 18 18 18 18 18 18 18 18 9 2 2 2 2 2 2 2 2
2 2 2 2 2 2 2 2 8 18 1 1 1 1 18 18 18 18 18 18 18 18 18 18 3 3 18 18 18 18 18 18 18 18 18 18 18 18 18 18 18 9 2 2 2 2 2 2 2 2
2 2 2 2 2 2 2 2 8 18 18 18 18 18 18 18 18 18 18 18 18 18 18 18 18 18 18 18 18 18 18 18 18 18 18 18 18 18 18 18 18 9 2 2 2 2 2 2 2 2
2 2 2 2 2 2 2 2 8 18 18 18 18 18 18 18 18 18 3 18 18 18 18 18 18 18 18 18 18 18 18 18 18 18 18 18 18 18 18 18 18 9 2 2 2 2 2 2 2 2
2 2 2 2 2 2 2 2 8 18 18 18 18 18 18 18 18 18 3 18 18 18 18 18 18 18 18 18 18 18 18 18 18 18 18 18 18 18 18 18 18 9 2 2 2 2 2 2 2 2
2 2 2 2 2 2 2 2 8 18 18 18 18 18 3 3 3 3 3 3 3 3 18 18 18 18 18 18 18 18 18 18 18 18 18 18 18 18 18 18 18 9 2 2 2 2 2 2 2 2
2 2 2 2 2 2 2 2 8 18 18 18 18 18 3 18 18 18 18 18 18 18 18 18 18 18 18 18 18 18 18 18 18 18 18 18 18 18 18 18 18 9 2 2 2 2 2 2 2 2
2 2 2 2 2 2 2 2 8 18 18 18 18 18 3 3 3 3 3 3 3 3 18 18 18 18 18 18 18 18 18 18 18 18 18 18 18 18 18 18 18 9 2 2 2 2 2 2 2 2
2 2 2 2 2 2 2 2 8 18 18 18 18 18 18 18 18 18 18 18 18 18 18 18 18 18 18 18 18 18 18 18 18 18 18 18 18 18 18 18 18 9 2 2 2 2 2 2 2 2
2 2 2 2 2 2 2 2 8 18 18 18 18 18 18 18 18 18 18 18 18 18 18 18 18 18 18 18 18 18 18 18 18 18 18 18 18 18 18 18 18 9 2 2 2 2 2 2 2 2
2 2 2 2 2 2 2 2 15 6 6 6 6 12 18 18 18 18 18 18 18 18 18 18 18 18 18 18 18 18 18 18 18 18 18 18 18 18 18 18 18 9 2 2 2 2 2 2 2 2
2 2 2 2 2 2 2 2 16 7 7 7 7 13 18 18 18 18 18 18 18 18 18 18 18 18 18 18 18 18 18 18 18 18 18 18 18 18 18 18 18 9 2 2 2 2 2 2 2 2
2 2 2 2 2 2 2 2 8 18 18 18 18 18 18 18 18 18 18 18 18 18 18 18 18 18 18 18 18 18 18 18 18 18 18 18 18 18 18 18 18 9 2 2 2 2 2 2 2 2
2 2 2 2 2 2 2 2 8 18 18 18 18 18 18 18 18 18 18 18 18 18 18 18 18 18 18 18 18 18 18 18 18 18 18 18 18 18 18 18 18 9 2 2 2 2 2 2 2 2
2 2 2 2 2 2 2 2 8 18 18 18 18 18 18 18 18 18 18 18 18 18 18 18 18 18 18 18 18 18 18 18 18 18 18 18 18 18 18 18 18 9 2 2 2 2 2 2 2 2
2 2 2 2 2 2 2 2 8 18 18 18 18 18 18 18 18 18 18 18 18 18 18 18 18 18 18 18 18 18 18 18 18 18 18 18 18 18 18 18 18 9 2 2 2 2 2 2 2 2
2 2 2 2 2 2 2 2 8 18 18 18 18 18 18 18 18 18 18 18 18 18 18 18 18 18 18 18 18 18 18 18 18 18 18 18 18 18 18 18 18 9 2 2 2 2 2 2 2 2
2 2 2 2 2 2 2 2 8 18 18 18 18 18 18 18 18 18 18 18 18 18 18 18 18 18 18 18 18 18 18 18 18 18 18 18 18 18 18 18 18 9 2 2 2 2 2 2 2 2
2 2 2 2 2 2 2 2 8 18 18 18 18 18 18 18 18 18 18 18 18 18 18 18 18 18 18 18 18 18 18 18 18 18 18 18 18 18 18 18 18 9 2 2 2 2 2 2 2 2
2 2 2 2 2 2 2 2 8 18 18 18 18 18 18 18 18 18 18 18 18 18 18 18 18 18 18 18 18 18 18 18 18 18 18 18 18 18 18 18 18 9 2 2 2 2 2 2 2 2
2 2 2 2 2 2 2 2 8 18 18 18 18 18 18 10 6 6 12 18 18 18 18 18 18 18 18 18 18 18 18 18 18 18 18 18 18 18 18 18 18 9 2 2 2 2 2 2 2 2
2 2 2 2 2 2 2 2 8 18 18 18 18 18 18 9 2 2 8 18 18 18 18 18 18 18 18 18 18 18 18 10 6 12 18 18 18 18 18 18 18 9 2 2 2 2 2 2 2 2
2 2 2 2 2 2 2 2 8 18 18 18 18 18 18 9 2 2 8 18 18 18 18 18 18 18 18 18 18 18 18 9 2 8 18 18 18 18 18 18 18 9 2 2 2 2 2 2 2 2
2 2 2 2 2 2 2 2 15 6 6 6 6 6 6 14 2 2 15 6 6 6 6 6 6 6 6 6 6 6 6 14 2 15 6 6 6 6 6 6 6 14 2 2 2 2 2 2 2 2
2 2 2 2 2 2 2 2 2 2 2 2 2 2 2 2 2 2 2 2 2 2 2 2 2 2 2 2 2 2 2 2 2 2 2 2 2 2 2 2 2 2 2 2 2 2 2 2 2 2
2 2 2 2 2 2 2 2 2 2 2 2 2 2 2 2 2 2 2 2 2 2 2 2 2 2 2 2 2 2 2 2 2 2 2 2 2 2 2 2 2 2 2 2 2 2 2 2 2 2
2 2 2 2 2 2 2 2 2 2 2 2 2 2 2 2 2 2 2 2 2 2 2 2 2 2 2 2 2 2 2 2 2 2 2 2 2 2 2 2 2 2 2 2 2 2 2 2 2 2
2 2 2 2 2 2 2 2 2 2 2 2 2 2 2 2 2 2 2 2 2 2 2 2 2 2 2 2 2 2 2 2 2 2 2 2 2 2 2 2 2 2 2 2 2 2 2 2 2 2
2 2 2 2 2 2 2 2 2 2 2 2 2 2 2 2 2 2 2 2 2 2 2 2 2 2 2 2 2 2 2 2 2 2 2 2 2 2 2 2 2 2 2 2 2 2 2 2 2 2
2 2 2 2 2 2 2 2 2 2 2 2 2 2 2 2 2 2 2 2 2 2 2 2 2 2 2 2 2 2 2 2 2 2 2 2 2 2 2 2 2 2 2 2 2 2 2 2 2 2
2 2 2 2 2 2 2 2 2 2 2 2 2 2 2 2 2 2 2 2 2 2 2 2 2 2 2 2 2 2 2 2 2 2 2 2 2 2 2 2 2 2 2 2 2 2 2 2 2 2
2 2 2 2 2 2 2 2 2 2 2 2 2 2 2 2 2 2 2 2 2 2 2 2 2 2 2 2 2 2 2 2 2 2 2 2 2 2 2 2 2 2 2 2 2 2 2 2 2 2